24 176 16 16
0 1 2 3 4 5 0 6 0 1 2 3 4 5 0 6 0 1 2 7 8 9 0 6 0 1 2 10 4 5 0 11 12 13 2 3 4 14 12 15 0 6 0 6 0 6 0 1 2 16 17 18 19 20 2 21 22 23 0 6 0 11 12 13 2 24 12 13 2 24 12 13 2 24 12 13 2 25 0 11 26 27 0 28 29 30 22 23 0 31 32 33 2 34 35 36 37 38 38 38 38 39 40 41 38 38 38 38 38 38 38 42 43 44 38 42 43 45 38 38 38 38 38 38 38 46 47 48 0 6 0 1 2 21 22 23 0 1 2 49 12 15 0 1 2 16 17 50 51 52 53 54 0 55 56 57 2 58 53 54 0 55 56 57 2 58 53 54 0 59 8 60 12 61 62 63
64 65 66 67 68 69 70 71 72 73 66 67 68 69 70 71 72 73 66 74 75 76 70 71 72 73 66 77 68 69 70 78 79 80 66 67 68 81 82 83 72 84 72 84 72 84 72 73 66 77 85 86 87 88 66 89 90 91 72 84 72 92 79 80 66 93 82 94 66 93 82 94 66 93 82 94 66 95 72 96 97 98 72 99 90 100 90 91 72 101 102 103 66 104 105 106 107 38 108 109 38 110 111 112 38 113 114 113 114 113 114 39 115 116 108 117 118 119 38 38 38 113 114 113 114 38 120 121 72 92 64 65 66 89 90 91 72 73 66 122 82 83 72 73 66 77 123 124 125 126 127 128 129 130 131 132 66 133 134 135 129 130 131 132 66 133 134 135 129 136 75 137 82 138 139 63
140 141 66 67 142 143 144 145 146 147 66 67 142 143 144 145 146 147 66 148 149 150 144 145 146 147 66 77 142 143 144 151 140 141 66 67 142 152 153 154 146 155 146 155 146 155 146 147 66 156 157 158 87 88 66 159 146 155 146 155 146 160 140 141 66 161 153 103 66 161 153 103 66 161 153 103 66 159 146 162 163 164 146 155 146 155 146 155 146 162 165 103 66 166 120 167 107 38 168 169 38 170 171 172 38 173 174 173 174 173 174 170 171 116 168 175 176 166 38 38 38 173 174 173 174 38 120 177 146 160 178 141 66 159 146 155 146 147 66 179 153 154 146 147 66 77 180 181 140 182 146 147 66 183 184 185 66 186 187 188 66 183 184 185 66 186 187 188 66 148 149 189 153 190 191 63
90 192 66 67 193 194 82 83 72 73 66 67 195 196 82 83 72 73 66 67 68 81 82 83 72 73 66 77 195 196 82 197 90 192 66 67 195 198 153 199 72 84 72 200 201 202 203 204 205 206 207 208 209 210 211 212 213 214 215 216 72 99 90 192 66 161 153 103 66 161 153 103 66 161 153 103 66 217 70 218 163 219 72 200 201 202 203 220 221 222 223 224 205 225 120 226 107 38 38 38 38 227 228 229 38 38 38 230 231 232 231 233 118 234 231 235 176 166 38 38 108 109 38 38 38 38 120 236 237 238 239 240 211 212 213 214 215 241 66 179 153 199 72 73 66 77 242 243 90 91 72 73 66 244 245 246 66 186 127 247 66 244 245 246 66 248 249 250 66 67 251 252 153 253 105 106
146 147 66 254 255 158 153 154 146 147 66 67 142 152 153 154 146 147 66 67 142 152 153 154 146 147 66 77 142 152 153 154 146 147 66 67 142 152 153 154 146 155 146 256 257 258 259 260 261 262 263 264 265 265 265 265 266 267 268 269 146 155 146 147 66 161 153 103 66 161 153 103 66 161 153 103 66 270 271 272 87 273 146 256 257 258 259 265 265 274 263 275 261 276 265 277 265 265 265 265 265 260 261 278 38 38 38 120 279 280 279 281 176 282 279 281 176 166 38 38 168 283 265 265 265 265 265 284 263 264 265 265 265 265 266 267 268 285 66 179 153 154 146 147 66 156 157 286 146 155 146 147 66 287 146 147 66 287 146 147 66 287 146 147 66 288 144 289 66 254 255 158 153 290 120 291
72 73 66 292 293 294 153 199 72 73 66 67 193 295 153 296 70 297 66 67 195 198 153 199 72 73 66 77 193 295 153 199 72 73 66 67 195 198 153 298 201 202 203 299 300 301 302 303 40 304 305 306 307 308 40 309 310 311 312 313 314 315 221 316 66 161 153 103 66 161 153 103 66 161 153 103 66 317 318 319 320 321 201 322 323 301 302 324 305 325 305 326 327 328 329 330 37 230 231 232 231 233 40 331 38 332 333 334 38 230 231 335 336 337 338 339 340 341 38 332 333 334 38 38 108 117 342 343 344 345 305 346 347 348 310 311 312 349 211 350 223 351 221 352 211 353 354 355 215 216 72 73 66 186 72 73 66 186 72 73 66 186 72 73 66 356 79 80 66 357 358 359 360 361 120 226
146 147 66 287 146 362 153 154 146 147 66 254 255 158 153 363 144 289 66 67 142 152 153 154 146 147 66 364 255 158 153 154 146 147 66 67 142 152 153 365 257 258 259 366 367 368 369 370 176 159 146 160 371 372 176 373 374 375 376 377 378 379 380 381 66 161 153 103 66 161 153 103 66 161 153 103 66 382 383 384 385 386 257 258 387 388 389 390 146 155 146 391 176 392 393 330 37 120 279 280 279 281 176 394 265 265 266 395 396 397 279 398 399 399 399 400 327 401 265 265 266 395 396 402 168 175 403 404 405 406 146 147 66 407 374 408 409 265 265 274 263 264 265 265 265 265 266 267 268 269 146 147 66 287 146 147 66 287 146 147 66 287 146 147 66 410 140 141 66 411 257 258 259 265 265 412
72 73 66 186 72 101 153 296 70 297 66 292 293 294 153 413 79 80 66 67 193 295 153 199 72 73 66 414 293 294 153 413 64 65 66 67 193 415 416 417 323 301 302 418 419 420 421 422 176 95 72 99 90 423 176 89 245 424 425 426 427 428 429 430 66 161 153 103 66 161 153 103 66 161 153 103 66 431 432 433 434 435 323 301 436 437 438 439 72 84 72 440 176 441 139 330 37 38 38 38 38 110 111 442 231 233 40 443 444 445 38 446 338 399 338 447 111 442 231 233 40 443 444 445 38 110 403 448 85 449 72 73 66 450 245 451 419 452 40 453 307 308 40 453 307 454 310 311 312 455 215 241 66 186 72 73 66 186 72 73 66 186 72 73 66 450 90 192 66 288 300 301 302 456 329 63
146 147 66 287 146 362 153 363 144 289 66 287 146 362 153 457 140 141 66 254 255 158 153 154 146 147 66 159 146 362 153 457 140 141 66 254 255 458 257 258 387 459 460 461 144 145 146 391 176 159 146 155 146 391 176 159 146 147 66 288 144 462 144 289 66 161 153 103 66 161 153 103 66 161 153 103 66 270 463 464 257 258 387 388 389 461 271 465 146 155 146 391 176 392 191 330 37 38 38 38 38 170 171 466 279 281 176 166 467 444 396 397 468 469 469 470 171 466 279 281 176 166 467 444 396 471 403 472 157 286 146 147 66 287 146 473 144 474 176 382 371 372 176 382 371 475 374 476 477 267 268 285 66 287 146 147 66 287 146 147 66 287 146 147 66 287 146 147 66 478 479 480 369 481 191 63
314 482 483 484 314 485 486 487 488 489 483 484 314 485 486 490 491 492 483 493 494 495 486 487 314 496 205 497 498 485 486 490 491 492 483 493 494 499 300 500 501 502 503 504 488 505 314 506 507 508 498 509 314 506 507 508 498 482 483 484 488 505 488 489 483 510 486 511 483 510 486 511 483 510 486 224 205 512 513 514 300 500 501 502 515 504 516 517 314 509 314 518 519 520 521 330 37 332 333 334 38 227 228 229 38 522 507 523 524 525 444 526 527 528 529 530 228 531 333 532 507 523 524 525 444 533 534 535 207 536 314 482 483 484 314 509 488 537 507 538 539 540 507 538 539 541 542 543 544 545 312 546 483 484 314 482 483 484 314 482 483 484 314 482 483 484 314 482 483 493 547 548 503 549 521 63
263 275 261 262 263 550 263 550 263 275 261 262 263 550 263 550 263 275 261 262 263 550 263 550 263 275 261 262 263 550 263 550 263 275 261 262 263 551 367 274 263 550 263 550 263 550 263 275 261 262 263 550 263 275 261 262 263 275 261 262 263 550 263 275 261 262 263 275 261 262 263 275 261 262 263 275 261 262 263 551 367 274 263 550 263 550 263 550 263 550 263 275 261 552 553 265 265 265 266 554 265 260 261 276 265 260 261 276 265 265 409 555 556 557 557 558 261 276 266 559 261 276 265 265 409 260 560 561 263 550 263 275 261 262 263 550 263 275 261 262 263 275 261 262 263 550 263 550 263 264 409 260 261 262 263 275 261 262 263 275 261 262 263 275 261 262 263 275 261 262 263 550 263 551 553 562
279 279 279 279 279 279 279 279 279 279 279 279 279 279 279 279 279 279 279 279 279 279 279 279 279 279 279 279 279 279 279 279 279 279 279 279 279 279 279 279 279 279 279 279 279 279 279 279 279 279 279 279 279 279 279 279 279 279 279 279 279 279 279 279 279 279 279 279 279 279 279 279 279 279 279 279 279 279 279 279 279 279 279 279 279 279 279 279 279 279 279 279 279 279 279 279 279 279 279 563 279 279 279 279 279 279 279 279 279 279 279 279 279 279 279 279 279 279 279 563 279 279 279 279 279 279 279 279 279 279 279 279 279 279 279 279 279 279 279 279 279 279 279 279 279 279 279 279 279 279 279 279 279 279 279 279 279 279 279 279 279 279 279 279 279 279 279 279 279 279 279 279 279 279 279 279
279 279 279 279 279 279 279 279 279 279 279 279 279 279 279 279 279 279 279 279 279 279 279 279 279 279 279 279 279 279 279 279 279 279 279 279 279 279 279 279 279 279 279 279 279 279 279 279 279 279 279 279 279 279 279 279 279 279 279 279 279 279 279 279 279 279 279 279 279 279 279 279 279 279 279 279 279 279 279 279 279 279 279 279 279 279 279 279 279 279 279 279 279 279 279 279 279 279 564 565 566 567 568 569 570 565 571 572 572 572 570 565 571 572 570 565 571 572 573 574 575 567 568 569 572 572 573 574 576 577 578 279 279 279 279 279 279 279 279 279 279 279 279 279 279 279 279 279 279 279 279 279 279 279 279 279 279 279 279 279 279 279 279 279 279 279 279 279 279 279 279 279 279 279 279 279
279 279 279 279 279 279 279 279 279 279 279 279 279 279 279 279 279 279 279 279 279 279 279 279 279 279 279 279 279 279 279 279 279 279 279 279 279 279 279 279 279 279 279 279 279 279 279 279 279 279 279 279 279 279 279 279 279 279 279 279 279 279 279 279 279 279 279 279 279 279 279 279 279 279 279 279 279 279 279 279 279 279 279 279 279 279 279 279 279 279 279 279 279 279 279 279 279 279 579 580 581 582 583 584 585 580 586 587 587 587 588 580 586 587 588 580 586 587 588 580 581 582 583 584 589 587 588 580 590 591 592 279 279 279 279 279 279 279 279 279 279 279 279 279 279 279 279 279 279 279 279 279 279 279 279 279 279 279 279 279 279 279 279 279 279 279 279 279 279 279 279 279 279 279 279 279
279 279 279 279 279 279 279 279 279 279 279 279 279 279 279 279 279 279 279 279 279 279 279 279 279 279 279 279 279 279 279 279 279 279 279 279 279 279 279 279 279 279 279 279 279 279 279 279 279 279 279 279 279 279 279 279 279 279 279 279 279 279 279 279 279 279 279 279 279 279 279 279 279 279 279 279 279 279 279 279 279 279 279 279 279 279 279 279 279 279 279 279 279 279 279 279 279 279 579 580 581 582 582 583 593 594 595 587 587 587 588 594 595 587 588 580 586 587 588 580 581 582 582 583 584 589 588 580 590 591 592 279 279 279 279 279 279 279 279 279 279 279 279 279 279 279 279 279 279 279 279 279 279 279 279 279 279 279 279 279 279 279 279 279 279 279 279 279 279 279 279 279 279 279 279 279
279 279 279 279 279 279 279 279 279 279 279 279 279 279 279 279 279 279 279 279 279 279 279 279 279 279 279 279 279 279 279 279 279 279 279 279 279 279 279 279 279 279 279 279 279 279 279 279 279 279 279 279 279 279 279 279 279 279 279 279 279 279 279 279 279 279 279 279 279 279 279 279 279 279 279 279 279 279 279 279 279 279 279 279 279 279 279 279 279 279 279 279 279 279 279 279 279 279 579 580 581 582 582 582 596 597 598 587 587 587 599 600 595 587 588 580 586 587 588 580 581 582 582 582 583 584 585 580 590 591 592 279 279 279 279 279 279 279 279 279 279 279 279 279 279 279 279 279 279 279 279 279 279 279 279 279 279 279 279 279 279 279 279 279 279 279 279 279 279 279 279 279 279 279 279 279
279 279 279 279 279 279 279 279 279 279 279 279 279 279 279 279 279 279 279 279 279 279 279 279 279 279 279 279 279 279 279 279 279 279 279 279 279 279 279 279 279 279 279 279 279 279 279 279 279 279 279 279 279 279 279 279 279 279 279 279 279 279 279 279 279 279 279 279 279 279 279 279 279 279 279 279 279 279 279 279 279 279 279 279 279 279 279 279 279 279 279 279 279 279 279 279 279 279 579 594 601 582 582 582 602 603 604 587 587 587 588 594 595 587 588 580 586 587 588 580 581 582 582 582 582 583 593 580 590 591 592 279 279 279 279 279 279 279 279 279 279 279 279 279 279 279 279 279 279 279 279 279 279 279 279 279 279 279 279 279 279 279 279 279 279 279 279 279 279 279 279 279 279 279 279 279
279 279 279 279 279 279 279 279 279 279 279 279 279 279 279 279 279 279 279 279 279 279 279 279 279 279 279 279 279 279 279 279 279 279 279 279 279 279 279 279 279 279 279 279 279 279 279 279 279 279 279 279 279 279 279 279 279 279 279 279 279 279 279 279 279 279 279 279 279 279 279 279 279 279 279 279 279 279 279 279 279 279 279 279 279 279 279 279 279 279 279 279 279 279 279 279 279 279 605 597 606 607 607 607 608 609 610 611 611 611 611 597 598 587 612 609 613 587 612 609 614 607 607 607 607 607 615 609 616 591 592 279 279 279 279 279 279 279 279 279 279 279 279 279 279 279 279 279 279 279 279 279 279 279 279 279 279 279 279 279 279 279 279 279 279 279 279 279 279 279 279 279 279 279 279 279
279 279 279 279 279 279 279 279 279 279 279 279 279 279 279 279 279 279 279 279 279 279 279 279 279 279 279 279 279 279 279 279 279 279 279 279 279 279 279 279 279 279 279 279 279 279 279 279 279 279 279 279 279 279 279 279 279 279 279 279 279 279 279 279 279 279 279 279 279 279 279 279 279 279 279 279 279 279 279 279 279 279 279 279 279 279 279 279 279 279 279 279 279 279 279 279 279 279 617 603 618 619 619 619 620 603 618 621 622 619 620 603 604 587 623 603 604 587 623 603 618 619 619 619 619 619 620 603 624 591 592 279 279 279 279 279 279 279 279 279 279 279 279 279 279 279 279 279 279 279 279 279 279 279 279 279 279 279 279 279 279 279 279 279 279 279 279 279 279 279 279 279 279 279 279 279
279 279 279 279 279 279 279 279 279 279 279 279 279 279 279 279 279 279 279 279 279 279 279 279 279 279 279 279 279 279 279 279 279 279 279 279 279 279 279 279 279 279 279 279 279 279 279 279 279 279 279 279 279 279 279 279 279 279 279 279 279 279 279 279 279 279 279 279 279 279 279 279 279 279 279 279 279 279 279 279 279 279 279 279 279 279 279 279 279 279 279 279 279 279 279 279 279 279 579 580 625 626 627 626 628 580 629 630 631 632 633 580 586 587 588 580 586 587 588 580 634 632 635 626 627 626 628 580 636 637 638 279 279 279 279 279 279 279 279 279 279 279 279 279 279 279 279 279 279 279 279 279 279 279 279 279 279 279 279 279 279 279 279 279 279 279 279 279 279 279 279 279 279 279 279 279
279 279 279 279 279 279 279 279 279 279 279 279 279 279 279 279 279 279 279 279 279 279 279 279 279 279 279 279 279 279 279 279 279 279 279 279 279 279 279 279 279 279 279 279 279 279 279 279 279 279 279 279 279 279 279 279 279 279 279 279 279 279 279 279 279 279 279 279 279 279 279 279 279 279 279 279 279 279 279 279 279 279 279 279 279 279 279 279 279 279 279 279 279 279 279 279 279 279 579 594 595 587 587 587 588 594 639 640 641 642 643 580 586 644 645 580 586 644 645 580 646 642 647 644 648 587 588 580 649 619 650 279 279 279 279 279 279 279 279 279 279 279 279 279 279 279 279 279 279 279 279 279 279 279 279 279 279 279 279 279 279 279 279 279 279 279 279 279 279 279 279 279 279 279 279 279
279 279 279 279 279 279 279 279 279 279 279 279 279 279 279 279 279 279 279 279 279 279 279 279 279 279 279 279 279 279 279 279 279 279 279 279 279 279 279 279 279 279 279 279 279 279 279 279 279 279 279 279 279 279 279 279 279 279 279 279 279 279 279 279 279 279 279 279 279 279 279 279 279 279 279 279 279 279 279 279 279 279 279 279 279 279 279 279 279 279 279 279 279 279 279 279 279 279 651 652 653 654 654 654 654 652 653 654 655 656 657 658 659 660 661 658 659 660 661 658 662 656 663 660 664 654 665 609 666 667 668 279 279 279 279 279 279 279 279 279 279 279 279 279 279 279 279 279 279 279 279 279 279 279 279 279 279 279 279 279 279 279 279 279 279 279 279 279 279 279 279 279 279 279 279 279
279 279 279 279 279 279 279 279 279 279 279 279 279 279 279 279 279 279 279 279 279 279 279 279 279 279 279 279 279 279 279 279 279 279 279 279 279 279 279 279 279 279 279 279 279 279 279 279 279 279 279 279 279 279 279 279 279 279 279 279 279 279 279 279 279 279 279 279 279 279 279 279 279 279 279 279 279 279 279 279 279 279 279 279 279 279 279 279 279 279 279 279 279 279 279 279 279 279 669 670 671 670 671 670 671 670 671 670 671 670 671 670 671 670 671 670 671 670 671 670 671 670 671 670 671 670 672 603 673 670 674 279 279 279 279 279 279 279 279 279 279 279 279 279 279 279 279 279 279 279 279 279 279 279 279 279 279 279 279 279 279 279 279 279 279 279 279 279 279 279 279 279 279 279 279 279
279 279 279 279 279 279 279 279 279 279 279 279 279 279 279 279 279 279 279 279 279 279 279 279 279 279 279 279 279 279 279 279 279 279 279 279 279 279 279 279 279 279 279 279 279 279 279 279 279 279 279 279 279 279 279 279 279 279 279 279 279 279 279 279 279 279 279 279 279 279 279 279 279 279 279 279 279 279 279 279 279 279 279 279 279 279 279 279 279 279 279 279 279 279 279 279 279 279 675 676 677 676 677 676 677 676 677 676 677 676 677 676 677 676 677 676 677 676 677 676 677 676 677 676 677 676 678 679 680 676 681 279 279 279 279 279 279 279 279 279 279 279 279 279 279 279 279 279 279 279 279 279 279 279 279 279 279 279 279 279 279 279 279 279 279 279 279 279 279 279 279 279 279 279 279 279
